NO ./asset/tile000.xpm
SO ./asset/tile003.xpm
WE ./asset/tile005.xpm
EA ./asset/tile007.xpm

C 135,206,235
F 64,64,64



1111111111111111111111
1000000000000000000001
1000000000000000000001
1000001111111000000001
1000000000000000000001
1000000000000000000001
1000N00000000000000001
1111111111111111111111