NO ./asset/strip_01.xpm
SO ./asset/strip_02.xpm
WE ./asset/strip_03.xpm
EA ./asset/strip_04.xpm

C 45,8,144
F 169,8,7

111111111111111111111111111111111111111
10E000000011000000000000000000000000001
111110000111000000000000000011111100001
100000000000000000000000000000000000001
101111111111111111111111111111111111001
100000001000001000000001000000000001001
100000000000000000000000000000000001001
100000001000001000000001000000000000001
111111111111111111111111111111111111111