NO ./asset/tile000.xpm
SO ./asset/tile003.xpm
WE ./asset/tile005.xpm
EA ./asset/tile007.xpm

C 135,206,235
F 139,69,19


















111111111111111111111111111111111111111
10S000000011000000000000000000000000001
101100000111000000000000000011111100001
100100000000000000000000000010000100001
101111101101011111000111111110000101111
100000001101010001000100000000000100001
101101111101111101110111111011110111101
101000000000000000000000001000000000001
101111111011111011111111101111111101111
100000001000001000000001000000000001001
101111101011101011111101111111111101101
100000001000000010000000000000000000001
111111111111111111111111111111111111111