NO ./asset/tile000.xpm
SO ./asset/tile003.xpm
WE ./asset/tile005.xpm
EA ./asset/tile007.xpm

F 220,100,0
C 225,30,0

1111111111
1000000001
1000000001
1000110001
1000000001111111
100000N000000001
1111111111111111
