NO ./asset/tile000.xpm
SO ./asset/tile003.xpm
WE ./asset/tile005.xpm
EA ./asset/tile007.xpm

C 135,206,235
F 139,69,19

11111111111111111111111111111111111111111
10000000000000000000000000000000000000001
10111111111111110000011111111111111111001
10100000000000100000010000000000000001001
10101111111000101111110111111111111001001
10101000001000100000010000000000001001001
10101011101000101111110111110111101001001
10101010101000100000000000100100101001001
10101010101111101111111110111110111001001
10100000100000000000000000000000000000001
10111110111110111111111111110111111111101
10000010000010000000000000000100000000101
10111010111010111111111111110101111110101
10100010100010000000000000000100000000101
10101110101110111111111111111101111110101
10000000000000000000000000000000000000W01
11111111111111111111111111111111111111111
